xxxxxxxxxxxxxxxxxxxxx
xx      x   x      xx
xx xx x x x x x xx xx
x  x  x   x   x  x  x
x xx xxxxxxxxxxx xx x
x  x     xxx     x  x
xx x x x     x x x xx
xx   x x xxx x x   xx
x  x x x x.x x x x  x
x xx x x x.x x x xx x
x  x x x x.x x x x  x
xx   x x     x x   xx
xx x x x xxx x x x xx
x  x             x  x
x xx xxxxxxxxxxx xx x
x  x  x   x   x  x  x
xx xx x x x x x xx xx
xx      x   x      xx
xxxxxxxxxxxxxxxxxxxxx